##-#########-##
##-#########-##
##-#########-##
-------#####-##
-#####-#####-##
############--#
#-----#---###-#
#-###-#-#--##-#
#-###---##----#
#*########-####