##-#########-##
##-#########-##
##-#########-##
##--#####----##
###-#####-#####
###-#####----##
##--#######-###
##-###-###----#
##-###-###-####
##-----###---*#