-#########-####
-#########-####
-#########-####
-----###----###
###---###-#####
###-#-###----##
##--#--########
##-###-###*####
##-###-----####
###############