#-########-####
#--###-----####
##-###-###---##
##--##-#####-##
###-##----##-##
###-####-###-##
##--####-######
##-#####-----##
##-#######-####
#######*---####