#-##########-##
#---########-##
###---####---##
#####-####-####
#####-####----#
##----#########
#####-------###
###########--##
######----##-##
#*-----##----##