############-##
############-##
############-##
############-##
############-##
############--#
#############-#
#############-#
#############-#
#############-#